FDXB_DEBUG	LITERAL1
FDXB_DEBUG_PRINT	LITERAL1
FDXB_CARRIER_HZ	LITERAL1
FDXB_BUFFER_SIZE	LITERAL1

FdxB	KEYWORD1

Flag	KEYWORD1
flag_t	LITERAL1

Tag	KEYWORD1
tag_t	LITERAL1

Fifo	KEYWORD1
push	KEYWORD2
pop	KEYWORD2
peek	KEYWORD2
empty	KEYWORD2
size	KEYWORD2

Decoder	KEYWORD1
putStateChange	KEYWORD2
getBit	KEYWORD2

Parser	KEYWORD1
putStateChange	KEYWORD2
getTag	KEYWORD2
